S,W,_,_,_,_,_,T,_
_,_,_,W,_,_,_,_,K
_,_,W,_,W,_,_,_,_
_,_,_,_,W,_,_,W,W
W,W,_,_,_,_,_,_,E
_,_,W,_,_,_,_,W,W
_,_,W,T,_,_,_,_,_
_,K,_,_,_,_,_,W,_
_,_,W,_,_,_,_,W,K
"Objectives,1,2,3,4,5",,,,,,,,
"Hints,1,2,3,4,5",,,,,,,,
